1 7
2 4 4 0 0
4 4 4 4 4
4 4 4 4 4
4 4 4 4 4
4 4 4 4 0

0 3 3 3 0
3 3 3 3 3
3 3 3 3 3
3 3 3 3 0
0 3 3 3 0

4 4 4 4 4
4 4 0 0 4
4 4 0 0 4
4 4 0 0 4
0 4 4 4 4

5 3 3 3 0
3 3 3 3 3
3 3 3 3 3
3 3 3 3 5
0 0 3 3 0

4 4 4 0 0
0 4 4 4 4
4 4 4 4 4
4 4 4 4 4
4 0 4 4 0

3 0 3 3 0
3 3 3 3 3
3 3 3 3 3
0 3 3 3 0
3 3 3 3 3

0 3 3 0 3
3 3 3 3 0
3 0 0 0 3
3 0 0 0 3
0 3 3 3 3

3 3 3 3 0
3 3 3 3 3
0 3 3 3 3
3 3 3 3 3
3 1 3 0 0

