0 1
4 4 4 4 4
2 4 0 4 4
4 4 4 0 4
4 4 0 0 4
4 4 4 4 4

4 4 4 4 4
5 0 0 0 4
4 0 4 0 4
4 0 4 0 0
4 4 4 0 4

3 3 3 3 3
3 3 3 3 3
3 3 3 0 3
0 3 0 3 3
3 3 3 3 0

4 4 4 4 4
4 0 0 0 4
4 0 0 0 4
4 0 0 0 4
4 4 0 4 4

4 4 4 0 4
4 4 4 4 0
4 0 0 0 4
4 0 0 0 4
4 4 4 4 4

4 4 4 4 5
4 4 4 4 4
4 4 0 4 4
4 4 4 4 4
4 4 4 4 4

1 0 0 0 0
0 0 0 0 0
0 0 0 0 0
0 0 0 0 0
0 0 0 0 0

