0 9
2 4 4 4 4
4 4 4 4 4
4 4 4 4 4
4 4 4 4 4
4 4 4 4 4

3 3 3 3 0
3 3 3 3 3
3 3 3 3 3
3 3 3 3 3
3 3 3 3 3

4 4 4 4 4
4 4 4 4 4
4 4 4 4 4
4 4 4 4 4
0 4 4 4 4

0 3 3 3 3
3 3 3 3 3
3 3 3 3 3
0 3 3 3 3
3 3 3 3 3

4 4 4 4 0
4 4 4 4 4
4 4 4 4 4
0 4 4 4 4
4 4 4 4 4

3 3 3 3 3
3 3 3 3 3
3 3 3 3 3
3 3 3 3 3
3 3 3 3 0

1 4 4 4 4
4 4 4 4 4
4 4 4 4 4
4 4 4 4 4
4 4 4 4 4

