1 5
2 4 4 4 0
0 4 4 4 4
4 4 4 4 0
4 4 4 4 0
4 4 0 4 4

0 3 3 3 0
3 3 3 3 3
3 3 3 3 3
3 3 3 3 3
3 3 3 3 3

0 3 3 3 0
3 3 3 3 3
3 3 3 3 3
3 3 3 3 3
0 3 3 3 3

3 3 3 3 5
3 3 3 3 3
3 3 3 3 3
3 3 3 3 3
3 3 3 3 3

3 3 3 3 0
3 3 3 3 3
3 3 3 3 3
3 3 3 3 0
3 3 3 3 3

4 4 4 4 4
4 4 4 4 4
4 4 4 4 4
4 4 4 4 5
4 4 4 4 4

3 3 3 0 3
3 3 3 3 3
3 3 3 3 3
3 3 3 3 3
3 3 3 3 3

0 0 3 3 3
1 3 3 3 0
3 3 3 3 0
3 3 3 3 3
0 3 3 3 0

